      #
     ###
    #####
   Destroy
  ###the###
 ###########
######m######
 ###########
  ##center#
   #bloc##
    #####
     ###
      #
