
      #
     ###
    #####
   #######
  #########
 ###########
###Gun:(m):[-
 ###########
  #########
   #######
    #####
     ###
      #
