     ####
    ##  ##
   ##    ##
  ##      ##
 ##        ##
####<m>[<# ###
 ##        ##
  ##      ##
   ##    ##
    ##  ##
     ####
