        ####
       ##()##
      ###[- ##
     ##      ##
    #####[|   ##
   ##          ##
  ##   /()[-    ##
 ##    ########  ##
##()   #[O    #   ##
########(m)[- #[>  ##
##()   #[O    #   ##
 ##    ########  ##
  ##   \()[{    ##
   ##          ##
    #####[-   ##
     ##      ##
      ###[< ##
       ##()##
        ####
